111111111111111111
100000000000000001
10000000P0000P0001
1000000000000C0001
1000P000E000000001
100000000000000001
1000P00000000P0001
111111111111111111